
F 255,222,255
C 225,30,050

NO ./pics/mandatory/def/colorstone.xpm
SO ./pics/mandatory/def/eagle.xpm
EA ./pics/mandatory/def/redbrick.xpm
WE ./pics/mandatory/def/purplestone.xpm


 111111111111111
 100000110000101
 100001000000101
 111100000010101
 100000000010101
 1000E0001111101
 100000000000001
 100000000000001
 111111000111101
 100000000000001
 111111111111111
