NO ./pics/mandatory/def/colorstone.xpm
SO ./pics/mandatory/def/eagle.xpm
WE ./pics/mandatory/def/purplestone.xpm
EA ./pics/mandatory/def/redbrick.xpm

F 255, 222, 204
C 225,30,0

1111111111111
1000000000001
1000000000001
10000001E0001
1000000010001
1000000000001
1111111111111
