
F 255,222, 204
C 225, 30,0

NO ./pics/mandatory/def/colorstone.xpm
SO ./pics/mandatory/def/eagle.xpm
EA ./pics/mandatory/def/redbrick.xpm
WE ./pics/mandatory/def/purplestone.xpm







 11111111111111              
1100000000001111111
 1111111000000000001           
10000001E0001111111
 1111000000010001
1000000000001111
1111111111111