
F 255,222,255
C 225,30,050

NO ./pics/mandatory/def/colorstone.xpm
SO ./pics/mandatory/def/eagle.xpm
EA ./pics/mandatory/def/redbrick.xpm
WE ./pics/mandatory/def/purplestone.xpm


    11111111111111              
111111000E0011111111
 1111111001000000001
 11111111111111111111
111111111111111111
100000010001111111111
 11110000011  10010001
10000000000011111111111
1111111111111
