NO ./pics/bonus/wall1.xpm
SO ./pics/bonus/wall2.xpm
WE ./pics/bonus/wall3.xpm
EA ./pics/bonus/wall4.xpm

F 34, 38, 38
C 47, 79, 79


111111111111111111111111
100000001111111111111111
100011100000000000000001
10000W011111111111111101
10000000001    100000000111111111111111111111111111111111111111111111
100000000001111000000000000000000000000000000000000000000000000000001
1000000111100000000000000000000000000000000000000000000000000000000001
10000002002000000000000111111111111111111111111111111111111110000000011
100000011110000000000001                                  11000000001
100000000000000000000001                                110000000011
111121111111111111111111                              1100000000011
111000001111111111000001                             100000000011
1110000011       1000001111111111111111            110000000001
1111211111       1000000000000000000001           1100000000001
1000000001       1000000000000000000001          1100000000011
1000000001       1000000000000000000001       11110000000011
1000000001       1000000000000000000001       11100000000011
1000000001111111110000000000000000000011111111110000000011
10000000020000000200000000011100000000200000002000000001
10000000020000000200000000011100000000200000002000000001
10000000011111111100000000000000000000111111111000000001
1000000001       1000000000000000000001       1000000001
1000000001       1000000000000000000001       1000000001
1000000001       1000000000000000000001       1000000001
1000000001       1000000000000000000001       1000000001
1111001111       1111111111000111111111       1111001111
	1221                   11211                  1001
11110011111111111111111111100011111111111111111111221111
10000000000000000000000000000000000000000000000000000001
10000000000000000100000000000000000000000000000000000001
10000000010000000000000001000000000000010000000000000001
10000000000000000000000000000000000000000000000010000001
10000000000000000000000000000100000000000000000000000001
10000000000100000000000000000000000000000010000000000001
10000000000000000000000000000000010000000000000000000001
10000001000000000000100000000000000000000000000000000001
10000000000000000000000000000000000000000000000000000001
10000000000000000000000000000010000000001000000000000001
10000000000000010000000000000000000000000000000000000001
10000001000000000000000000000000000000000000000010000001
11111111111111111111111111111111111111111111111111111111